
5fffffaffffffff6
ept   e  s     e
e 0 5f8ff6 0t0 e
e e ex   e e e e
epe 4ff6 2 e e e
e e    e   e eye
e e 51 4fff7 e e
epe e     m  e e
e 2 2 3ffffff7 e
e   t j        e
4ffffffffffffff7